##########################|#
#                      J # #
# ###################### # #
# ###!              !### # #
# ###                ### V #
# ########      ############
# !                       !#
# #############  ###########
# #############  ###########
# ##########!      !########
#      !###          ###   #
#### ######          ### # #
#       ####!      !#### #J#
####### ######    ###### # #
#j      #!               #v#
############################