#D##########################
#.                        !#
#########################  #
#                          #
##### #################### #
#!#                   R !# #
#v######### ###########  # #
#J#   #   #   ####   ### # #
#   #   # # ## j#  #  ##*# #
######### # #  ### ## #### #
#           #       #    # #
#V#### ################# ###
#r#                      #|#
#J######################## #
#           !!!            *
############################
!!