#|##########################
#JJJJJJJJJJJJJJJJJJJJJJJJJJ#
#JJJJJJJJJJJJJJJJJJJJJJJVVJ#
#JJ                 JJJJ.VJ#
#JJVJJJJJJJJJJJJJJJ JJJJ VJ#
#JJVJj       JJJ    V    VJ#
#JJVJJJJJJJJ JJJ JJJJ VVVVJ#
#JJVJJJJJJJJ     JJJJ    VJ#
#JJVVVVVVJJJRRJRRJJJJVVV VJ#
#JJJJJJJVJJJRRJRRJJJJVVV VJ#
#JV   vJ                 VJ#
#JV JJJJ VVVRVVVRVVVVVVVVVJ#
#JV      JJJJRRRJJJJJJJJJJJ#
#JVVVVVVVVVVVVVVVVVVVVVVVVJ#
#JJJJJJJJJJJJJJJJJJJJJJJJJJ#
############################
!!!!