############################
#JJJJ                  VVVj#
#JJJ    #####JJ#####    VVV#
#JJ      ####$$####      VV#
#J        ###JJ###        V#
#          ##||##          #
# VVVVVVVVVV####JJJJJJJJJJJ#
#                          #
#             .            #
#JJJJJJJJJJJ####VVVVVVVVVV #
#          ##DD##          #
#V        ###JJ###        J#
#VV      ####**####      JJ#
#VVV    #####JJ#####    JJJ#
#v                     JJJJ#
############################
!!!