#D#D#|#D#D#D####D#D#D#|#D#D#
#                          #
#!########################!#
#!!!!!!!!!!!!!!!!!!!!!!!!!!#
#############!!#############
#############!!#############
#     ######*RR*###       r#
# ### ######*RR*### ## #####
# ##   ######!!#### #!     #
#v## #              ##!!!# #
#J##*## ## # ## # # ######J#
#  #### ## #R##R# #     #  #
#**#    ##V#    #J#####!#**#
####J##### ##  ## #####!####
#D*  *###* j#**#***#** ! .D#
############################
!!!!!