######################D###|#
#                     .  # #
# #################### # # #
# ################!*!# #J#V#
#  ##!!!!!!!!!!!!#! !# #   #
#                ##V## #####
#  ##!!!!!!!!!!           r#
#R#############RR###########
#R#$ $#########RR###########
#R##########!      !########
#      !###          ###   #
## ## #####          ### # #
#       ####!      !####v# #
####### ######    ########J#
#j      #!                 #
############################
!